map_settings:
tiles_x=91
tiles_y=12
tiles_z=3
player_start=2,1,3
player_finish=9,2,3
background_image="Path/to/background.png"
tile_set="path"

tiles:
1111111111111111111111111111111111111111111111111111111111111111111111111111111111111111111
1000000000000000000000000000000000000000000000000000000000000000000000000000000000000000001
1000000000000000000011111100000000000000000000000000000000000000000000000001111100000000001
1000000000000000000000000000000000000000000000000000000000000000000000000000000000000000001
1000000000000000000000000000000000111111111111110001111111111111000111000000000000000000001
1000000000000000000000000000001110000000000000000000000000000000000000000000000000011111001
1000000011110000000111000001110000000000000000000000000000000000000000011111111100000000001
1000000000000000000000000000000000000000000000000111000000000000000000000000000000000000001
1000000000000000000000000000000111000110011100000000000011111000000000000000000000000000001
1000000000000000000000001000000000000000011111111111111111111000000000000000000000000000001
1000000000000000000000011100000000000000000000000000000000000000000000000000000000000000001
1111111111111000111000111111111111111111111111000000000000111111111100000011111111111111111

objects:

enemy=teddy,8,2,3
enemy=goal,35,2,3
