map_settings:
tiles_x=40
tiles_y=10
tiles_z=3
player_start=2,2,3
player_finish=9,2,3
background_image="Path/to/background.png"
tile_set="path"

tiles:
00000000000000000000000000000000000000000000000000000000000000000000000000000000000000000
00000000000000000000000000000000000000000000000000000000000000000000001111111111111100000
00000000000000000000000000000000011110101111111111111111111111100011100000000000000000000
00000000000000000000000000000111000000000000000000000000000000000000000000000000000000000
00000001111000000011100000111000000000000000000000000000000000000000001111111110000000000
00000000000000000000000000000000000000000000000011100000000000000000000000000000000000000
00000000000000000000000000000011100011001110000000000001111100000000000000000000000000000
00000000000000000000000100000000000000001111111111111111111100000000000000000000000000000
00000000000000000000001110000000000000000000000000000000000000000000000000000000000000000
11111111111111111111111111111111111111111111100000000000011111111110000001111111111111111

objects:

enemy=teddy,8,2,3
enemy=teddy,18,2,3
enemy=teddy,28,2,3
enemy=goal,84,10,3
