map_settings:
tiles_x=40
tiles_y=10
player_start=2,2
player_finish=9,2
background_image="Path/to/background.png"
tile_set="path"

tiles:
0000000000000000000000000000000000000000
0000000000000000000000000000000000000000
0000000000000000000000000000000000000000
0000000000000000000000000000000000000000
0000000000000000000000000000000000000000
0000000000000000000000000000000000000000
0000000000000000000000000000000000000000
0000000000000000000000010000000000000000
0000000000000000000000111000000000000000
1111111111111111111111111111111111111111

objects:
enemy=teddy,8,3